Aarakocra|Humanoid|1/4|Ararakocra Pinions (@1d6@)::Aarakocra Scalp~5 can be used as a ritual headdress to summon an air elemental. All headdress wearers must be within 30 ft. of each other and perform a ritual dance, maintaining concentration is if concentrating on a spell. On the 3rd turn, the elemental appears within 60 ft. of them, obeys their spoken commands. It remains for 1 hour, until it or all of its summoners die, or until any of its summoners dismissit as a bonus action. The ritual cannot be performed again until after a short rest.
Abominable Yeti|Monstrosity|9|Abominable Yeti Hide~No immediate use. Can be crafted into armor that grants resistance to cold damage and advantage on Dexterity (Stealth) checks made to hide in snowy terrain.::Abominable Yeti Eye~No immediate use. Can be crafted into an amulet or circlet with 3 charges. Using 1 charge, the wearer can target one creature they can see within 30 feet. If the target can see the wearer, the target must succeed on a DC 18 Constitution saving throw against this magic or take 21 (6d6) cold damage and then be paralyzed for 1 minute, unless it is immune to cold damage. The target can repeat the saving throw at the end of each of its turns, ending the effect on itself on a success. If the target's saving throw is successful, or if the effect ends on it, the target is immune to this gaze for 1 hour. The amulet/circlet regains 1d3 charges after a long rest.
Faerie Dragon (Blue)|Dragon|2|Faerie Dragon Lungs~Can be squeezed at one creature within 5 feet of it. The target must succeed on a DC 11 Wisdom saving throw, or for 1 minute, the target can't take reactions and must roll a d6 at the start of each of its turns to determine its behavior during the turn: 1–4. The target takes no action or bonus action and uses all of its movement to move in a random direction. 5–6. The target doesn't move, and the only thing it can do on its turn is make a DC 11 Wisdom saving throw, ending the effect on itself on a success.
Faerie Dragon (Green)|Dragon|2|Faerie Dragon Lungs~Can be squeezed at one creature within 5 feet of it. The target must succeed on a DC 11 Wisdom saving throw, or for 1 minute, the target can't take reactions and must roll a d6 at the start of each of its turns to determine its behavior during the turn: 1–4. The target takes no action or bonus action and uses all of its movement to move in a random direction. 5–6. The target doesn't move, and the only thing it can do on its turn is make a DC 11 Wisdom saving throw, ending the effect on itself on a success.
Faerie Dragon (Indigo)|Dragon|2|Faerie Dragon Lungs~Can be squeezed at one creature within 5 feet of it. The target must succeed on a DC 11 Wisdom saving throw, or for 1 minute, the target can't take reactions and must roll a d6 at the start of each of its turns to determine its behavior during the turn: 1–4. The target takes no action or bonus action and uses all of its movement to move in a random direction. 5–6. The target doesn't move, and the only thing it can do on its turn is make a DC 11 Wisdom saving throw, ending the effect on itself on a success.
Faerie Dragon (Orange)|Dragon|1|Faerie Dragon Lungs~Can be squeezed at one creature within 5 feet of it. The target must succeed on a DC 11 Wisdom saving throw, or for 1 minute, the target can't take reactions and must roll a d6 at the start of each of its turns to determine its behavior during the turn: 1–4. The target takes no action or bonus action and uses all of its movement to move in a random direction. 5–6. The target doesn't move, and the only thing it can do on its turn is make a DC 11 Wisdom saving throw, ending the effect on itself on a success.
Faerie Dragon (Red)|Dragon|1|Faerie Dragon Lungs~Can be squeezed at one creature within 5 feet of it. The target must succeed on a DC 11 Wisdom saving throw, or for 1 minute, the target can't take reactions and must roll a d6 at the start of each of its turns to determine its behavior during the turn: 1–4. The target takes no action or bonus action and uses all of its movement to move in a random direction. 5–6. The target doesn't move, and the only thing it can do on its turn is make a DC 11 Wisdom saving throw, ending the effect on itself on a success.
Faerie Dragon (Violet)|Dragon|2|Faerie Dragon Lungs~Can be squeezed at one creature within 5 feet of it. The target must succeed on a DC 11 Wisdom saving throw, or for 1 minute, the target can't take reactions and must roll a d6 at the start of each of its turns to determine its behavior during the turn: 1–4. The target takes no action or bonus action and uses all of its movement to move in a random direction. 5–6. The target doesn't move, and the only thing it can do on its turn is make a DC 11 Wisdom saving throw, ending the effect on itself on a success.
Faerie Dragon (Yellow)|Dragon|1|Faerie Dragon Lungs~Can be squeezed at one creature within 5 feet of it. The target must succeed on a DC 11 Wisdom saving throw, or for 1 minute, the target can't take reactions and must roll a d6 at the start of each of its turns to determine its behavior during the turn: 1–4. The target takes no action or bonus action and uses all of its movement to move in a random direction. 5–6. The target doesn't move, and the only thing it can do on its turn is make a DC 11 Wisdom saving throw, ending the effect on itself on a success.
Allosaurus|Beast|2|Allosaurus Hide::Allosaurus Claws (@1d4@)
Ankylosaurus|Beast|3|Ankylosaurus Hide::Ankylosaurus Claws (@1d4@)
Arcanaloth|Fiend|12|Yugoloth Ichor~Can be used as a vial of acid.
Banshee|Undead|4|
Barlgura|Fiend|5|Barlgura Hide~No immediate use. Can be crafted into armor that grants resistance to poison damage.
Beholder|Aberration|13|Beholder Slime~Used as an Oil of Slipperiness.::Beholder Eyestalks (@1d4@)~No immediate use. 4 are used to summon a spectator.::Beholder Hide~No immediate use. Can be crafted into +1 armor that allows the wearer to use an action to cast the Levitate spell on themselves at will.::Large Beholder Eye~No immediate use. Can be crafted into an amulet that casts Antimagic Field once per day.::Small Beholder Eyes (@1d4@)~Casts a random beholder ray on each use. Once used, it can't be used until the next dawn. After @1d3+2@ uses, the eyes dessolves and becomes useless.
Beholder Zombie|Undead|5|
Blue Slaad|Aberration|7|Blue Slaad Hide::Blue Slaad Blood~No immediate use. Can be crafted into a Potion of Healing.
Bone Naga|Undead|4|
Bugbear Chief|Humanoid|3|Tattered Chain Shirt~Must be mended before use.::Tattered Shield~Must be mended before use.::Heart of Hruggek~When eaten, grants advantage on saving throws against being charmed, frightened, paralyzed, poisoned, stunned, or put to sleep.
Bullywug|Humanoid|1/4|Bullywug Hide::Bullywug Heart~No immediate use. Can be crafted into a Potion of Jumping: The drinker can jump twice their normal distance for one hour.
Cambion|Fiend|5|Tattered Scale Mail~Must be mended before use.::Cambion Blood~No immediate use. Can be crafted into a potion that grants a fire ray attack with a 120 ft. range and deals 3d6 fire damage. The potion wears off after one minute or @1d2+2@ uses, whichever comes first.::Cambion Eyes (@1d2@)~No immediate use. Can be used in crafting Eyes of Charming.
Chasme|Fiend|6|Chasme Carapace~No immediate use. Can be crafted into armor that grants resistance to poison damage.::Chasme Proboscis~Used as a war pick that deals double damage.|Target takes 24 (7d6) necrotic damage, and their hit point maximum is reduced by an amount equal to the necrotic damage taken. If this effect reduces a creature's hit point maximum to 0, the creature dies. This reduction to a creature's hit point maximum lasts until the creature finishes a long rest or until it is affected by a spell like greater restoration.
Crawling Claw|Undead|0|
Cyclops|Giant|6|Cyclops Toes (@1d4@)~Hunting trophy or collector's item.
Dao|Elemental|11|
Death Knight|Undead|17|Tattered Plate Armor~Must be mended before use.::Tattered Shield~Must be mended before use.
Death Slaad|Aberration|10|Death Slaad Hide::Death Slaad Claw~Used as a battleaxe that deals an additional 2d6 necrotic damage.::Death Slaad Blood~No immediate use. Can be crafted into a Potion of Greater Healing.
Death Tyrant|Undead|14|Small Death Tyrant Eyes (@1d4@)~Casts a random death tyrant ray on each use. Once used, it can't be used until the next dawn. After @1d3+2@ uses, the eyes dessolves and becomes useless.::Death Tyrant Central Eye~Can be used to emit an invisible, magical 150-foot cone of negative energy. Any creature in that area can't regain hit points. Any humanoid that dies there becomes a zombie under the weilder's command. The dead humanoid retains its place in the initiative order and animates at the start of its next turn, provided that its body hasn't been completely destroyed. This cone remains active for 1 minute or 3 rounds, whichever comes first, or until dismissed. After the effect has ended, roll d20. On a 1 the eye crumbles to dust. The eye has 3 charges. 1d3 charges are regained after a long rest.
Demilich|Undead|18|
Displacer Beast|Monstrosity|3|Displacer Beast Tentacles (@1d2@)~Used as a whip that deals 1d6 bludgeoning damage and 1d6 piercing damage.::Displacer Beast Hide~No immediate use. Can be crafted into a Cloak of Displacement.
Drow Elite Warrior|Humanoid|5|
Drow Mage|Humanoid|7|Tattered Mage Robe~Must be mended before use.::Drow Mage Heart~No immediate use. Can be used in crafting an amulet or circlet that allows the wearer to summon a quasit, or attempt to summon a shadow demon with a 50 percent chance of success. The summoned demon appears in an unoccupied space within 60 feet of its summoner, acts as an ally of its summoner, and can't summon other demons. It remains for 10 minutes, until it or its summoner dies, or until its summoner dismisses it as an action. Once used, this property can't be used again until the next dawn.
Drow Priestess of Lolth|Humanoid|8|Tattered Scale Mail~Must be mended before use.::Drow Mage Heart~No immediate use. Can be used in crafting an amulet or circlet that allows the wearer to summon a quasit, or attempt to summon a shadow demon with a 50 percent chance of success. The summoned demon appears in an unoccupied space within 60 feet of its summoner, acts as an ally of its summoner, and can't summon other demons. It remains for 10 minutes, until it or its summoner dies, or until its summoner dismisses it as an action. Once used, this property can't be used again until the next dawn.
Duodrone|Construct|1/4|
Empyrean|Celestial|23|Empyrean Maul~A +2 maul. If the target is a creature, it must succeed on a DC 15 Constitution saving throw or be stunned until the end of the weilder's next turn. Once per day, the weilder can strike the ground, creating a tremor. All other creatures on the ground within 30 feet of the weilder must succeed on a DC 18 Strength saving throw or be knocked prone.
Fire Snake|Elemental|1|Fire Snake Hide~No immediate use. 2 can be crafted into armor that grants resistance to fire damage.
Flameskull|Undead|4|
Flumph|Aberration|1/8|
Fomorian|Giant|8|Formorian Eyes (@1d2@)~No immediate use. Can be crafted into Eyes of Cursing. These goggles have 3 charges. Using 1 charge forces a creature you can see within 60 feet of it to make a DC 14 Charisma saving throw. The creature takes 27 (6d8) psychic damage on a failed save, or half as much damage on a successful one. Using 2 charges also allows a failed save to curse the creature with magical deformities. While deformed, the creature has its speed halved and has disadvantage on ability checks, saving throws, and attacks based on Strength or Dexterity. The transformed creature can repeat the saving throw whenever it finishes a long rest, ending the effect on a success. The goggles regain 1d3 charges after a long rest.
Galeb Duhr|Elemental|6|Mote of Elemental Dust~No immediate use. Used as a material component for a Conjure Elementals spell, or in crafting an Elemental Gem for summoning earth elementals.::Galeb Duhr Chunks (@1d4@)~Used as +1 sling stones.::Geode Heart~Can be used to animate 1 boulder you can see within 60 ft. The boulder has statistics like those of a galeb duhr, except it has Intelligence 1 and Charisma 1, it can't be charmed or frightened, and can't animate boulders. It obeys simple commands to the best of its ability. A boulder remains animated as long as the weilder maintains concentration, up to 1 minute (as if concentrating on a spell).
Gas Spore|Plant|1/2|
Githyanki Knight|Humanoid|8|Tattered Plate Armor~Must be mended before use.
Githyanki Warrior|Humanoid|3|Tattered Half Plate Armor~Must be mended before use.
Githzerai Monk|Humanoid|2|
Githzerai Zerth|Humanoid|6|Githzerai Zerth Heart~No immediate use. Can be crafted into an amulet or circlet that allows the user to apply their Wisdom modifier to their AC when not wearing armor or carrying a shield.
Gnoll Fang of Yeenoghu|Fiend|4|
Gnoll Pack Lord|Humanoid|2|Gnoll Pack Lord Head~Grants advantage on Intimidation checks made against the pack lord's gnoll pack when held or worn outwardly.
Goblin Boss|Humanoid|1|Tattered Chain Shirt~Must be mended before use.::Tattered Shield~Must be mended before use.::Heart of Hruggek~When eaten, grants advantage on saving throws against being charmed, frightened, paralyzed, poisoned, stunned, or put to sleep.
Goristro|Fiend|17|Goristro Horns (@1d2@)~No immediate use. Can be crafted into a Potion of Resistance to Cold, Fire or Lightning.::Goristro Hide~No immediate use. Can be crafted into +2 armor that grants resistance to bludgeoning, piercing, and slashing damage from nonmagical attacks.::Goristro Eyes (@1d2@)~No immediate use. Can be crafted into a Potion of The Path, which has the following effects: You have can perfectly recall every route they have taken within the past 8 hours, and automatically succeed on ability checks made to escape a maze or similar areas.
Gray Slaad|Aberration|9|Gray Slaad Hide::Gray Slaad Blood~No immediate use. Can be crafted into a Potion of Healing.
Green Slaad|Aberration|8|Green Slaad Hide::Green Slaad Blood~No immediate use. Can be crafted into a Potion of Healing.
Grell|Aberration|3|Grell Hide~No immediate use. 2 can be crafted into armor or a cloak that grants resistance to lightning damage and +2 to passive Perception checks.::Grell Tentacles (@1d4@)~Used as a whip that deals 1d10 piercing damage. The target is also grappled (escape DC 15). If the target is Medium or smaller, it is also restrained until this grapple ends. While grappling the target, the grell has advantage on attack rolls against it and can't use this attack against other targets. When the grell moves, any Medium or smaller target it is grappling moves with it.|Target must succeed on a DC 11 Constitution saving throw or be poisoned for 1 minute. The poisoned target is paralyzed, and it can repeat the saving throw at the end of each of its turns, ending the effect on a success.
Grick Alpha|Monstrosity|7|Grick Tentacles (@1d4@)~Used as a flail.::Grick Hide~No immediate use. Can be crafted into a cloak that gives advantage on Dexterity checks made to hide in rocky terrain.
Half-ogre|Giant|1|Half-ogre Toes (@1d4@)~Hunting trophy or collector's item.
Helmed Horror|Construct|4|
Hobgoblin Captain|Humanoid|3|Tattered Half Plate Armor~Must be mended before use.
Hobgoblin Warlord|Humanoid|6|Tattered Plate Armor~Must be mended before use.::Tattered Shield~Must be mended before use.
Hook Horror|Monstrosity|3|Hook Horror Shell~Can be used as a shield::Hook Horror Hooks (@1d2@)~Used as a pike that deals 2d6 damage.
Intellect Devourer|Aberration|2|Intellect Devourer Brain~No immediate use. Can be used to craft a helmet or circlet that allows the wearer to sense the presence and location of any creature within 300 feet of it that has an Intelligence of 3 or higher, regardless of interposing barriers, unless the creature is protected by a mind blank spell. Once used, this property can't be used again until the next dawn.
Jackalwere|Humanoid|1/2|Jackalwere Hide::Jackalwere Eyes (@1d2@)~No immediate use. Can be crafted into goggles. When wearing the goggles, the wearer can gaze at a target within 30 ft. This target must make a DC 10 Wisdom saving throw. On a failed save, the target succumbs to a magical slumber, falling unconscious for 10 minutes or until someone uses an action to shake the target awake. A creature that successfully saves against the effect is immune to this gaze for the next 24 hours. Undead and creatures immune to being charmed aren't affected by it. Once this property is use, it can't be used again until the next dawn.
Kenku|Humanoid|1/4|
Kuo-toa|Humanoid|1/4|Kuo-Toa Hide::Tattered Sticky Shield~Must be mended before use. When a creature misses the weilder with a melee weapon attack, you can use the sticky shield to catch the weapon. The attacker must succeed on a DC 11 Strength saving throw, or the weapon becomes stuck to the shield. If the weapon's wielder can't or won't let go of the weapon, the wielder is grappled while the weapon is stuck. While stuck, the weapon can't be used. A creature can pull the weapon free by taking an action to make a DC 11 Strength check and succeeding.
Kuo-toa Archpriest|Humanoid|6|Kuo-Toa Hide::Kuo-Toa Archpriest Eye~No immediate use. Can be crafted into a helmet or amulet that allows the wearer to sense the presence of any creature within 30 feet of it that is invisible or on the Ethereal Plane. They can pinpoint such a creature that is moving. Once this property is used, it can't be used again until the next dawn.
Kuo-toa Monitor|Humanoid|3|Kuo-Toa Hide
Kuo-toa Whip|Humanoid|1|Kuo-Toa Hide
Lizard King|Humanoid|4|Lizardfolk Hide
Lizard Queen|Humanoid|4|Lizardfolk Hide
Lizardfolk Shaman|Humanoid|2|Lizardfolk Hide
Manes|Fiend|1/8|Reeking Vapor~No immediate use. Will transform back into a Manes after one day.
Marid|Elemental|11|
Mezzoloth|Fiend|5|Yugoloth Ichor~Can be used as a vial of acid.
Mind Flayer|Aberration|7|Tattered Breastplate~Must be mended before use.::Mind Flayer Brain~No immediate use. Can be used to craft a helmet or circlet that emits psychic energy in a 60-foot cone. Each creature in that area must succeed on a DC 15 Intelligence saving throw or take 22 (4d8 + 4) psychic damage and be stunned for 1 minute. A creature can repeat the saving throw at the end of each of its turns, ending the effect on itself on a success. Once used, this property can't be used again until the next dawn.
Mind Flayer Arcanist|Aberration|8|Tattered Breastplate~Must be mended before use.::Mind Flayer Brain~No immediate use. Can be used to craft a helmet or circlet that emits psychic energy in a 60-foot cone. Each creature in that area must succeed on a DC 15 Intelligence saving throw or take 22 (4d8 + 4) psychic damage and be stunned for 1 minute. A creature can repeat the saving throw at the end of each of its turns, ending the effect on itself on a success. Once used, this property can't be used again until the next dawn.
Monodrone|Construct|1/8|
Mud Mephit|Elemental|1/4|
Myconid Adult|Plant|1/2|Pacifying Spore Sac~Can be squeezed at one creature you can see within 5 feet of it. The target must succeed on a DC 11 Constitution saving throw or be stunned for 1 minute. The target can repeat the saving throw at the end of each of its turns, ending the effect on itself on a success. Single use only.::Rapport Spore Sac~Can be squeezed or destroyed to create a 20-foot radius of spores. These spores can go around corners and affect only creatures with an Intelligence of 2 or higher that aren't undead, constructs, or elementals. Affected creatures can communicate telepathically with one another while they are within 30 feet of each other. The effect lasts for 1 hour. Single use only.
Myconid Sovereign|Plant|2|Hallucination Spore Sac~Can be squeezed at one creature you can see within 5 feet of it. The target must succeed on a DC 12 Constitution saving throw or be poisoned for 1 minute. The poisoned target is incapacitated while it hallucinates. The target can repeat the saving throw at the end of each of its turns, ending the effect on itself on a success. Single use only.::Pacifying Spore Sac~Can be squeezed at one creature you can see within 5 feet of it. The target must succeed on a DC 11 Constitution saving throw or be stunned for 1 minute. The target can repeat the saving throw at the end of each of its turns, ending the effect on itself on a success. Single use only.::Rapport Spore Sac~Can be squeezed or destroyed to create a 20-foot radius of spores. These spores can go around corners and affect only creatures with an Intelligence of 2 or higher that aren't undead, constructs, or elementals. Affected creatures can communicate telepathically with one another while they are within 30 feet of each other. The effect lasts for 1 hour. Single use only.::Animating Spore Sac~Can be squeezed at one corpse of a humanoid or a Large or smaller beast within 5 feet and release spores at the corpse. In 24 hours, the corpse rises as a spore servant. The corpse stays animated for 1d4 + 1 weeks or until destroyed, and it can't be animated again in this way. Single use only.
Myconid Sprout|Plant|0|Rapport Spore Sac~Can be squeezed or destroyed to create a 10-foot radius of spores. These spores can go around corners and affect only creatures with an Intelligence of 2 or higher that aren't undead, constructs, or elementals. Affected creatures can communicate telepathically with one another while they are within 30 feet of each other. The effect lasts for 1 hour.
Needle Blight|Plant|1/4|Needle Blight Needles (@1d6@)~Used as ammunition that deals double damage.
Nothic|Aberration|2|Nothic Hide::Nothic Eye~No immediate use. Can be crafted into goggles that allow the wearer to target one creature it can see within 30 feet of it. The target must succeed on a DC 12 Constitution saving throw against this magic or take 10 (3d6) necrotic damage.
Nycaloth|Fiend|9|Yugoloth Ichor~Can be used as a vial of acid.
Orc Eye of Gruumsh|Humanoid|2|Tattered Ring Mail~Must be mended before use.::Tattered Shield~Must be mended before use.
Orc War Chief|Humanoid|4|Tattered Chain Mail~Must be mended before use.
Orog|Humanoid|2|Tattered Plate Armor~Must be mended before use.
Pentadrone|Construct|2|
Peryton|Monstrosity|2|Peryton Pinions (@1d6@)::Peryton Hide::Peryton Antlers (@1d2@)~Hunting trophy or collector's item.
Piercer|Monstrosity|1/2|
Pixie|Fey|1/4|
Pteranodon|Beast|1/4|Pteranodon Hide::Pteranodon Claws (@1d2@)
Quadrone|Construct|1|
Quaggoth|Humanoid|2|Quaggoth Hide::Quaggoth Heart~No immediate use. Can be crafted into a Potion of Poison Resistance.
Quaggoth Spore Servant|Plant|1|
Quaggoth Thonot|Humanoid|3|Quaggoth Hide::Quaggoth Heart~No immediate use. Can be crafted into a Potion of Poison Resistance.
Quipper|Beast|0|Quipper Teeth (@1d4@)
Red Slaad|Aberration|5|Red Slaad Hide::Red Slaad Blood~No immediate use. Can be crafted into a Potion of Healing.
Revenant|Undead|5|Tattered Leather Armor~Must be mended before use.::Revenant Heart~No immediate use. Can be crafted into a Potion of Vitality.
Sahuagin Baron|Humanoid|5|Sahuagin Hide::Tattered Breastplate~Must be mended before use.::Sahuagin Skull~No immediate use. Can be crafted into a helmit that grants the effect of a Speak with Animals spell, but only works on sharks. Once used, this property can't be used again until the next dawn.
Sahuagin Priestess|Humanoid|2|Sahuagin Hide::Sahuagin Skull~No immediate use. Can be crafted into a helmit that grants the effect of a Speak with Animals spell, but only works on sharks. Once used, this property can't be used again until the next dawn.
Scarecrow|Construct|1|
Shadow Demon|Fiend|4|
Slaad Tadpole|Aberration|1/8|
Spectator|Aberration|3|Spectator Eyes (@1d4@)~Casts a random spectator ray on each use. Once used, it can't be used until the next dawn. After @1d3+2@ uses, the eyes dessolves and becomes useless.::Spectator Hide~No immediate use. Can be crafted into armor or a cloak that grants Spell Reflection. If the wearer makes a successful saving throw against a spell, or a spell attack misses it, they can choose another creature (including the spellcaster) it can see within 30 feet of it. The spell targets the chosen creature instead of the wearer. If the spell forced a saving throw, the chosen creature makes its own save. If the spell was an attack, the attack roll is rerolled against the chosen creature.
Poltergeist|Undead|2|
Spined Devil|Fiend|2|Spined Devil Blood~No immediate use. Can be crafted into a Potion of Poison Resistance.::Spined Devil Spines (@1d6@)~Used as ammunition that deals an additional 1d6 fire damage. If used as a dart, the piercing damage is 1d4.
Thri-kreen|Humanoid|1|Thri-Keen Carapace~No immediate use. 3 can be crafted into armor that can change color at will to match the color and texture of the surroundings, giving advantage on Stealth checks made to hide.
Tridrone|Construct|1/2|
Troglodyte|Humanoid|1/4|Troglodyte Hide~No immediate use. Can be crafted into armor that grants advantage on Stealth checks made to hide while underground.
Twig Blight|Plant|1/8|
Ultroloth|Fiend|13|Yugoloth Ichor~Can be used as a vial of acid.
Umber Hulk|Monstrosity|5|Umber Hulk Mandibles (@1d2@)~Used as a scimitar that deals double damage.::Umber Hulk Eyes (@1d2@)~No immediate use. Can be crafted into Eyes of Confusion. The Eyes have 3 charges. When a creature starts its turn within 30 feet of you and is able to see your eyes, you can use 1 charge ton magically force it to make a DC 15 Charisma saving throw. On a failed saving throw, the creature can't take reactions until the start of its next turn and rolls a d8 to determine what it does during that turn. On a 1 to 4, the creature does nothing. On a 5 or 6, the creature takes no action but uses all its movement to move in a random direction. On a 7 or 8, the creature makes one melee attack against a random creature, or it does nothing if no creature is within reach. The Eyes regain 1d3 charges after a long rest.
Vampire Spellcaster|Undead|15|
Vampire Warrior|Undead|15|Tattered Plate Armor~Must be mended before use.
Vine Blight|Plant|1/2|Vine Blight Husk~Can be used as a cloak that grants advantage to Stealth checks in forrested terrain.
Water Weird|Elemental|3|
Winged Kobold|Humanoid|1/4|
Yeti|Monstrosity|3|Yeti Hide~No immediate use. Can be crafted into armor that grants resistance to cold damage and advantage on Dexterity (Stealth) checks made to hide in snowy terrain.::Yeti Eye~No immediate use. Can be crafted into an amulet or circlet that allows the wearer can target one creature they can see within 30 feet. If the target can see the wearer, the target must succeed on a DC 18 Constitution saving throw against this magic or take 21 (6d6) cold damage and then be paralyzed for 1 minute, unless it is immune to cold damage. The target can repeat the saving throw at the end of each of its turns, ending the effect on itself on a success. If the target's saving throw is successful, or if the effect ends on it, the target is immune to this gaze for 1 hour. Once used, this property can't be used again until the next dawn.
Yochlol|Fiend|10|Yochlol Ichor~No immediate use. Can be crafted into a Potion of Polymorph (as the spell.::Yochlol Eye~No immediate use. Can be crafted into an amulet or circlet that allows the wearer to use an action to transform into a toxic mist. Any equipment being worn or carried is also transformed. While in mist form, the wearer is incapacitated and can't speak. They have a flying speed of 30 feet, can hover, and can pass through any space that isn't airtight. They has advantage on Strength, Dexterity, and Constitution saving throws, and are immune to nonmagical damage. While in mist form, the wearer can enter a creature's space and stop there. Each time that creature starts its turn with the wearer in its space, the creature must succeed on a DC 14 Constitution saving throw or be poisoned until the start of its next turn. While poisoned in this way, the target is incapacitated. If the wearer reverts to true form in another creature's space, they take 3d8 force damage. The mist form ends after 10 minutes or as a bonus action. Once used, this feature can't be used again until the next dawn.
Young Red Shadow Dragon|Dragon|13|Young Red Shadow Dragon Hide~No immediate use. Can be crafted into +1 armor that grants resistance to necrotic damage.
Young Remorhaz|Monstrosity|5|Young Remorhaz Fangs (@1d4@)~Used as a dagger.::Remorhaz Hide~No immediate use. Can be crafted into armor that grants resistance to fire and cold damage.
Yuan-ti Abomination|Monstrosity|7|
Yuan-ti Malison (Type 1)|Monstrosity|3|
Yuan-ti Malison (Type 2)|Monstrosity|3|
Yuan-ti Malison (Type 3)|Monstrosity|3|
Yuan-ti Malison|Monstrosity|3|
Yuan-ti Pureblood|Humanoid|1|
